######*#######################
####@@@@@@@@@@@@@@@@##########
####@##############@##########
####@###@@@@#######@##########
##@@@###@##@#######@##########
##@#####@##@#######@@@@@######
##@@@@@@@##@###########@######
###########@###########@######
####@@@@@##@###########@######
####@######@###########@######
####@@@@@@@@####@@@@@@@@######
###@@###########@######@@@@@##
###@############@##########@##
###@@@@@@@@@@@@@@@@@@@@@@##@##
###########################x##